111111111111
1PCE000001C1
111110111101
1C100000C101
101000111101
100010110001
111110000111
111111111111
