11111111111
100000C0101
1P100000111
111001001E1
1C100100101
10001110001
11111C00001
11111111111
